#################
#               #
#               #
#$              #
#               #
#               #
#      @        #
#################
